SNNNNNNNNNNNNNNN*NNN
N*N********N***N*N*N
N*N*N*NNNN*N*N*N*N*N
N*N*N*N**N*N*N*NNN*N
N*N*N*N**N*N*N*****N
N*N*N*N**N*N*N*NNNNN
N*NNN*N**N*N*N*N***N
N*****N**N*N*N*NNN*N
NNNNNNN**N*N*N***N*N
*********N*N*N***N*N
NNNNNNNNNN*N*N***N*N
N**********NNN***N*N
NNNNNNNNNN*****NNN*N
*******N*N**NNNN***N
NNNNNNNN*N********NN
NN*****N*N**NNNNNNNN
N***N**N*N**N*******
NNNNN**N*N**NNNNNNNN
*******N*N**********
NNNNNNNN*NNNNNNNNNNE
